"filename", "language", "Java", "comment", "blank", "total"
"c:\Users\user\Documents\DiscordBot\wwBot\src\main\java\wwBot\Card.java", "Java", 13, 19, 8, 40
"c:\Users\user\Documents\DiscordBot\wwBot\src\main\java\wwBot\Command.java", "Java", 7, 0, 5, 12
"c:\Users\user\Documents\DiscordBot\wwBot\src\main\java\wwBot\Deckbuilder.java", "Java", 62, 18, 29, 109
"c:\Users\user\Documents\DiscordBot\wwBot\src\main\java\wwBot\Game.java", "Java", 75, 7, 33, 115
"c:\Users\user\Documents\DiscordBot\wwBot\src\main\java\wwBot\GameStates\Day.java", "Java", 137, 21, 28, 186
"c:\Users\user\Documents\DiscordBot\wwBot\src\main\java\wwBot\GameStates\GameState.java", "Java", 31, 0, 11, 42
"c:\Users\user\Documents\DiscordBot\wwBot\src\main\java\wwBot\GameStates\LobbyState.java", "Java", 258, 95, 83, 436
"c:\Users\user\Documents\DiscordBot\wwBot\src\main\java\wwBot\GameStates\MainGameState.java", "Java", 134, 18, 33, 185
"c:\Users\user\Documents\DiscordBot\wwBot\src\main\java\wwBot\GameStates\MessagesMain.java", "Java", 43, 6, 19, 68
"c:\Users\user\Documents\DiscordBot\wwBot\src\main\java\wwBot\GameStates\Night.java", "Java", 10, 0, 7, 17
"c:\Users\user\Documents\DiscordBot\wwBot\src\main\java\wwBot\GameStates\PostGameState.java", "Java", 15, 3, 10, 28
"c:\Users\user\Documents\DiscordBot\wwBot\src\main\java\wwBot\GameStates\SemiMainGameState.java", "Java", 219, 20, 42, 281
"c:\Users\user\Documents\DiscordBot\wwBot\src\main\java\wwBot\Globals.java", "Java", 75, 19, 18, 112
"c:\Users\user\Documents\DiscordBot\wwBot\src\main\java\wwBot\Main.java", "Java", 118, 22, 36, 176
"c:\Users\user\Documents\DiscordBot\wwBot\src\main\java\wwBot\Player.java", "Java", 11, 0, 5, 16
"c:\Users\user\Documents\DiscordBot\wwBot\src\main\java\wwBot\PrivateCommand.java", "Java", 7, 0, 4, 11
"c:\Users\user\Documents\DiscordBot\wwBot\src\main\java\wwBot\ReadJSONCard.java", "Java", 43, 15, 24, 82
"Total", "-", 1258, 263, 395, 1916